00000000000000000000000000000000000000000000000000000000000000000000
00000000000000000000000002220000000000000000000000000000000000000000
00000000000000000000000000000000000000000000022200000000000000000000
00000000000000000022200000000000000000000000000000000000000000000000
00000002222200000000000000000000000000222000000000000000000000000000
00000000000000000000000000000000000000000000000000000000000000000000
22000000000000000220000002200000000000000000000000000000000000000000
11222222222222222110011221120011111111001111111111111111111111111111
11111111111111111110011111110011111100011111111111111111111111111111
11111111111111111110011011000011111001111111111111111111111111111111
11111111111111111110011110001111110011111111111111111111111111111111
11111111111111111110001110000000000011111111111111111111111111111111
11111111111111111111000000001011111111111111111111111111111111111111
11111111111111111111111111111111111111111111111111111111111111111111
11111111111111111111111111111111111111111111111111111111111111111111
11111111111111111111111111111111111111111111111111111111111111111111
11111111111111111111111111111111111111111111111111111111111111111111